"a" = (/turf,/area)
"b" = (/turf/TileFloor,/area)
"c" = (/mob/person,/turf/TileFloor,/area)
"d" = (/obj/weapon/billhook,/turf/TileFloor,/area)
"e" = (/obj/weapon/metalbat,/turf/TileFloor,/area)
"f" = (/obj/weapon/woodenbat,/turf/TileFloor,/area)

(1,1,1) = {"
aaaaaaaaaaaaaaaaaaaaaaaaaaaaaaaaaaaaaaaa
aaaaaaaaaaaaaaaaaaaaaaaaaaaaaaaaaaaaaaaa
bbbbbbbbbbbbbbbbbbbbbbbbbaaaaaaaaaaaaaaa
bbbbbbbbbbbbbbbbbbbbbbbbbaaaaaaaaaaaaaaa
bbbbbbbbbbbbbbbbbbbbbbbbbaaaaaaaaaaaaaaa
bbbbbbbbbbbbbbbbbbbbbbbbbaaaaaaaaaaaaaaa
bbbbbbbbbbbbbbbbbbbbbbbbbaaaaaaaaaaaaaaa
bbbbbbbbbbbbbbbbbbbbbbbbbaaaaaaaaaaaaaaa
bbbbbbbbbbbbbbbbbbbbbbbbbaaaaaaaaaaaaaaa
bbbbbbbbbbbbbbbbbbbbbbbbbaaaaaaaaaaaaaaa
bbbbbbbbbbbbbbbbbbbbbbbbbaaaaaaaaaaaaaaa
bbbbbbbbbbbbbbbbbbbbbbbbbaaaaaaaaaaaaaaa
bbbbbbbbbbbbbbbbbbbbbbbbbaaaaaaaaaaaaaaa
bbbbbbbbbbbbbbbbbbbbbbbbbaaaaaaaaaaaaaaa
bbbbbbbbbbbbbbbbbbbbbbbbbaaaaaaaaaaaaaaa
bbbbbbbbbbbbbbbbbbbbbbbbbaaaaaaaaaaaaaaa
bbbbbbbbbbbbbbbbbbbbbbbbbaaaaaaaaaaaaaaa
bbbbbbbbbbbbbbbbbbbbbbbbbaaaaaaaaaaaaaaa
bbbbbbbbbbbbbbbbbbbbbbbbbaaaaaaaaaaaaaaa
bbbbbbbbbbbbbbbbbbbbbbbbbaaaaaaaaaaaaaaa
bbbbbbbbbbbbbbbbbbbbbbbbbaaaaaaaaaaaaaaa
bbbbbbbbbbbbbbbbbbbbbbbbbaaaaaaaaaaaaaaa
bbbbbbbbbbbbbbbbbbbbbbbbbaaaaaaaaaaaaaaa
bbbbbbbbbbbbbbbbbbbbbbbbbaaaaaaaaaaaaaaa
bbbbbbbbbbbbbbbbbbbbbbbbbaaaaaaaaaaaaaaa
bbbbbbbbbbbbbbbbbbbbbbbbbaaaaaaaaaaaaaaa
bbbbbbbbbbbbbbbbbbbbbbbbbaaaaaaaaaaaaaaa
bbbbbbbbbbbbbbbbbbbbbbbbbaaaaaaaaaaaaaaa
bbbbbbbbbbbbbbbbbbbbbbbbbaaaaaaaaaaaaaaa
bbbbbbbbbbbbbbbbbbbbbbbbbaaaaaaaaaaaaaaa
bbbbbbbbbbbbbbbbbbbbbbbbbaaaaaaaaaaaaaaa
bbbbbbbbbbbbbbbbbbbbbbbbbaaaaaaaaaaaaaaa
bbbbbbbbbbbbbbbbbbbbbbbbbaaaaaaaaaaaaaaa
bbbbbbbbbbbbbbbbbbbbbbbbbaaaaaaaaaaaaaaa
bbbbbbbbbbbbbbbbbbbbbbbbbaaaaaaaaaaaaaaa
bbbbbbbbbbbbbbbbbbbbbbbbbaaaaaaaaaaaaaaa
bbbbbbbbbbbbbbbbbbbbbbbbbaaaaaaaaaaaaaaa
bbbbbbdefbbbbbbbbbbbbbbbbaaaaaaaaaaaaaaa
bbbbccbbbbbbbbbbbbbbbbbbbaaaaaaaaaaaaaaa
bbbbbbbbbbbbbbbbbbbbbbbbbaaaaaaaaaaaaaaa
"}

(1,1,2) = {"
aaaaaaaaaaaaaaaaaaaaaaaaaaaaaaaaaaaaaaaa
aaaaaaaaaaaaaaaaaaaaaaaaaaaaaaaaaaaaaaaa
aaaaaaaaaaaaaaaaaaaaaaaaaaaaaaaaaaaaaaaa
aaaaaaaaaaaaaaaaaaaaaaaaaaaaaaaaaaaaaaaa
aaaaaaaaaaaaaaaaaaaaaaaaaaaaaaaaaaaaaaaa
aaaaaaaaaaaaaaaaaaaaaaaaaaaaaaaaaaaaaaaa
aaaaaaaaaaaaaaaaaaaaaaaaaaaaaaaaaaaaaaaa
aaaaaaaaaaaaaaaaaaaaaaaaaaaaaaaaaaaaaaaa
aaaaaaaaaaaaaaaaaaaaaaaaaaaaaaaaaaaaaaaa
aaaaaaaaaaaaaaaaaaaaaaaaaaaaaaaaaaaaaaaa
aaaaaaaaaaaaaaaaaaaaaaaaaaaaaaaaaaaaaaaa
aaaaaaaaaaaaaaaaaaaaaaaaaaaaaaaaaaaaaaaa
aaaaaaaaaaaaaaaaaaaaaaaaaaaaaaaaaaaaaaaa
aaaaaaaaaaaaaaaaaaaaaaaaaaaaaaaaaaaaaaaa
aaaaaaaaaaaaaaaaaaaaaaaaaaaaaaaaaaaaaaaa
aaaaaaaaaaaaaaaaaaaaaaaaaaaaaaaaaaaaaaaa
aaaaaaaaaaaaaaaaaaaaaaaaaaaaaaaaaaaaaaaa
aaaaaaaaaaaaaaaaaaaaaaaaaaaaaaaaaaaaaaaa
aaaaaaaaaaaaaaaaaaaaaaaaaaaaaaaaaaaaaaaa
aaaaaaaaaaaaaaaaaaaaaaaaaaaaaaaaaaaaaaaa
aaaaaaaaaaaaaaaaaaaaaaaaaaaaaaaaaaaaaaaa
aaaaaaaaaaaaaaaaaaaaaaaaaaaaaaaaaaaaaaaa
aaaaaaaaaaaaaaaaaaaaaaaaaaaaaaaaaaaaaaaa
aaaaaaaaaaaaaaaaaaaaaaaaaaaaaaaaaaaaaaaa
aaaaaaaaaaaaaaaaaaaaaaaaaaaaaaaaaaaaaaaa
aaaaaaaaaaaaaaaaaaaaaaaaaaaaaaaaaaaaaaaa
aaaaaaaaaaaaaaaaaaaaaaaaaaaaaaaaaaaaaaaa
aaaaaaaaaaaaaaaaaaaaaaaaaaaaaaaaaaaaaaaa
aaaaaaaaaaaaaaaaaaaaaaaaaaaaaaaaaaaaaaaa
aaaaaaaaaaaaaaaaaaaaaaaaaaaaaaaaaaaaaaaa
aaaaaaaaaaaaaaaaaaaaaaaaaaaaaaaaaaaaaaaa
aaaaaaaaaaaaaaaaaaaaaaaaaaaaaaaaaaaaaaaa
aaaaaaaaaaaaaaaaaaaaaaaaaaaaaaaaaaaaaaaa
aaaaaaaaaaaaaaaaaaaaaaaaaaaaaaaaaaaaaaaa
aaaaaaaaaaaaaaaaaaaaaaaaaaaaaaaaaaaaaaaa
aaaaaaaaaaaaaaaaaaaaaaaaaaaaaaaaaaaaaaaa
aaaaaaaaaaaaaaaaaaaaaaaaaaaaaaaaaaaaaaaa
aaaaaaaaaaaaaaaaaaaaaaaaaaaaaaaaaaaaaaaa
aaaaaaaaaaaaaaaaaaaaaaaaaaaaaaaaaaaaaaaa
aaaaaaaaaaaaaaaaaaaaaaaaaaaaaaaaaaaaaaaa
"}

(1,1,3) = {"
aaaaaaaaaaaaaaaaaaaaaaaaaaaaaaaaaaaaaaaa
aaaaaaaaaaaaaaaaaaaaaaaaaaaaaaaaaaaaaaaa
aaaaaaaaaaaaaaaaaaaaaaaaaaaaaaaaaaaaaaaa
aaaaaaaaaaaaaaaaaaaaaaaaaaaaaaaaaaaaaaaa
aaaaaaaaaaaaaaaaaaaaaaaaaaaaaaaaaaaaaaaa
aaaaaaaaaaaaaaaaaaaaaaaaaaaaaaaaaaaaaaaa
aaaaaaaaaaaaaaaaaaaaaaaaaaaaaaaaaaaaaaaa
aaaaaaaaaaaaaaaaaaaaaaaaaaaaaaaaaaaaaaaa
aaaaaaaaaaaaaaaaaaaaaaaaaaaaaaaaaaaaaaaa
aaaaaaaaaaaaaaaaaaaaaaaaaaaaaaaaaaaaaaaa
aaaaaaaaaaaaaaaaaaaaaaaaaaaaaaaaaaaaaaaa
aaaaaaaaaaaaaaaaaaaaaaaaaaaaaaaaaaaaaaaa
aaaaaaaaaaaaaaaaaaaaaaaaaaaaaaaaaaaaaaaa
aaaaaaaaaaaaaaaaaaaaaaaaaaaaaaaaaaaaaaaa
aaaaaaaaaaaaaaaaaaaaaaaaaaaaaaaaaaaaaaaa
aaaaaaaaaaaaaaaaaaaaaaaaaaaaaaaaaaaaaaaa
aaaaaaaaaaaaaaaaaaaaaaaaaaaaaaaaaaaaaaaa
aaaaaaaaaaaaaaaaaaaaaaaaaaaaaaaaaaaaaaaa
aaaaaaaaaaaaaaaaaaaaaaaaaaaaaaaaaaaaaaaa
aaaaaaaaaaaaaaaaaaaaaaaaaaaaaaaaaaaaaaaa
aaaaaaaaaaaaaaaaaaaaaaaaaaaaaaaaaaaaaaaa
aaaaaaaaaaaaaaaaaaaaaaaaaaaaaaaaaaaaaaaa
aaaaaaaaaaaaaaaaaaaaaaaaaaaaaaaaaaaaaaaa
aaaaaaaaaaaaaaaaaaaaaaaaaaaaaaaaaaaaaaaa
aaaaaaaaaaaaaaaaaaaaaaaaaaaaaaaaaaaaaaaa
aaaaaaaaaaaaaaaaaaaaaaaaaaaaaaaaaaaaaaaa
aaaaaaaaaaaaaaaaaaaaaaaaaaaaaaaaaaaaaaaa
aaaaaaaaaaaaaaaaaaaaaaaaaaaaaaaaaaaaaaaa
aaaaaaaaaaaaaaaaaaaaaaaaaaaaaaaaaaaaaaaa
aaaaaaaaaaaaaaaaaaaaaaaaaaaaaaaaaaaaaaaa
aaaaaaaaaaaaaaaaaaaaaaaaaaaaaaaaaaaaaaaa
aaaaaaaaaaaaaaaaaaaaaaaaaaaaaaaaaaaaaaaa
aaaaaaaaaaaaaaaaaaaaaaaaaaaaaaaaaaaaaaaa
aaaaaaaaaaaaaaaaaaaaaaaaaaaaaaaaaaaaaaaa
aaaaaaaaaaaaaaaaaaaaaaaaaaaaaaaaaaaaaaaa
aaaaaaaaaaaaaaaaaaaaaaaaaaaaaaaaaaaaaaaa
aaaaaaaaaaaaaaaaaaaaaaaaaaaaaaaaaaaaaaaa
aaaaaaaaaaaaaaaaaaaaaaaaaaaaaaaaaaaaaaaa
aaaaaaaaaaaaaaaaaaaaaaaaaaaaaaaaaaaaaaaa
aaaaaaaaaaaaaaaaaaaaaaaaaaaaaaaaaaaaaaaa
"}
